0 0 0 0 0 0 0 0 0 0 0 0 0 0 0 0 0 0 0 0 0 0 0 0 0 0 0 0 0 0 0 0 0 0 0 0 0 0 0 0 0 0 0 0 0 0 0 0 0 0 0 0
0 0 0 0 0 0 0 0 0 0 0 0 0 0 0 0 0 0 0 0 0 0 0 0 0 0 0 0 0 0 0 0 0 0 0 0 0 0 0 0 0 0 0 0 0 0 0 0 0 0 0 0
0 0 0 0 0 0 0 0 0 0 0 0 0 0 0 0 0 0 0 0 0 0 0 0 0 0 0 0 0 0 0 0 0 0 0 0 0 0 0 0 0 0 0 0 0 0 0 0 0 0 0 0
0 0 0 0 0 0 0 0 0 0 0 0 0 0 0 0 0 0 0 0 0 0 0 0 0 0 0 0 0 0 0 0 0 0 0 0 0 0 0 0 0 0 0 0 0 0 0 0 0 0 0 0
0 0 0 0 41 41 41 41 0 0 0 0 41 41 41 41 0 0 0 0 41 41 41 41 0 0 0 0 41 41 41 41 0 0 0 0 41 41 41 41 0 0 0 0 41 41 41 41 0 0 0 0
0 0 0 0 41 41 41 41 0 0 0 0 41 41 41 41 0 0 0 0 41 41 41 41 0 0 0 0 41 41 41 41 0 0 0 0 41 41 41 41 0 0 0 0 41 41 41 41 0 0 0 0
0 0 0 0 41 41 41 41 0 0 0 0 41 41 41 41 0 0 0 0 41 41 41 41 0 0 0 0 41 41 41 41 0 0 0 0 41 41 41 41 0 0 0 0 41 41 41 41 0 0 0 0
0 0 0 0 41 41 41 41 0 0 0 0 41 41 41 41 0 0 0 0 41 41 41 41 0 0 0 0 41 41 41 41 0 0 0 0 41 41 41 41 0 0 0 0 41 41 41 41 0 0 0 0
0 0 0 0 41 41 41 41 0 0 0 0 41 41 41 41 0 0 0 0 41 41 41 41 0 0 0 0 41 41 41 41 0 0 0 0 41 41 41 41 0 0 0 0 41 41 41 41 0 0 0 0
0 0 0 0 41 41 41 41 0 0 0 0 41 41 41 41 0 0 0 0 41 41 41 41 0 0 0 0 41 41 41 41 0 0 0 0 41 41 41 41 0 0 0 0 41 41 41 41 0 0 0 0
0 0 0 0 41 41 41 41 0 0 0 0 41 41 41 41 0 0 0 0 41 41 41 41 0 0 0 0 41 41 41 41 0 0 0 0 41 41 41 41 0 0 0 0 41 41 41 41 0 0 0 0
0 0 0 0 41 41 41 41 0 0 0 0 41 41 41 41 0 0 0 0 41 41 41 41 0 0 0 0 41 41 41 41 0 0 0 0 41 41 41 41 0 0 0 0 41 41 41 41 0 0 0 0
0 0 0 0 41 41 41 41 0 0 0 0 41 41 41 41 0 0 0 0 41 41 41 41 44 44 44 44 41 41 41 41 0 0 0 0 41 41 41 41 0 0 0 0 41 41 41 41 0 0 0 0
0 0 0 0 41 41 41 41 0 0 0 0 41 41 41 41 0 0 0 0 41 41 41 41 44 44 44 44 41 41 41 41 0 0 0 0 41 41 41 41 0 0 0 0 41 41 41 41 0 0 0 0
0 0 0 0 41 41 41 41 0 0 0 0 41 41 41 41 0 0 0 0 41 41 41 41 44 44 44 44 41 41 41 41 0 0 0 0 41 41 41 41 0 0 0 0 41 41 41 41 0 0 0 0
0 0 0 0 41 41 41 41 0 0 0 0 41 41 41 41 0 0 0 0 41 41 41 41 44 44 44 44 41 41 41 41 0 0 0 0 41 41 41 41 0 0 0 0 41 41 41 41 0 0 0 0
0 0 0 0 41 41 41 41 0 0 0 0 41 41 41 41 0 0 0 0 41 41 41 41 0 0 0 0 41 41 41 41 0 0 0 0 41 41 41 41 0 0 0 0 41 41 41 41 0 0 0 0
0 0 0 0 41 41 41 41 0 0 0 0 41 41 41 41 0 0 0 0 41 41 41 41 0 0 0 0 41 41 41 41 0 0 0 0 41 41 41 41 0 0 0 0 41 41 41 41 0 0 0 0
0 0 0 0 41 41 41 41 0 0 0 0 41 41 41 41 0 0 0 0 0 0 0 0 0 0 0 0 0 0 0 0 0 0 0 0 41 41 41 41 0 0 0 0 41 41 41 41 0 0 0 0
0 0 0 0 41 41 41 41 0 0 0 0 41 41 41 41 0 0 0 0 0 0 0 0 0 0 0 0 0 0 0 0 0 0 0 0 41 41 41 41 0 0 0 0 41 41 41 41 0 0 0 0
0 0 0 0 41 41 41 41 0 0 0 0 41 41 41 41 0 0 0 0 0 0 0 0 0 0 0 0 0 0 0 0 0 0 0 0 41 41 41 41 0 0 0 0 41 41 41 41 0 0 0 0
0 0 0 0 41 41 41 41 0 0 0 0 41 41 41 41 0 0 0 0 0 0 0 0 0 0 0 0 0 0 0 0 0 0 0 0 41 41 41 41 0 0 0 0 41 41 41 41 0 0 0 0
0 0 0 0 0 0 0 0 0 0 0 0 0 0 0 0 0 0 0 0 41 41 41 41 0 0 0 0 41 41 41 41 0 0 0 0 0 0 0 0 0 0 0 0 0 0 0 0 0 0 0 0
0 0 0 0 0 0 0 0 0 0 0 0 0 0 0 0 0 0 0 0 41 41 41 41 0 0 0 0 41 41 41 41 0 0 0 0 0 0 0 0 0 0 0 0 0 0 0 0 0 0 0 0
0 0 0 0 0 0 0 0 0 0 0 0 0 0 0 0 0 0 0 0 41 41 41 41 0 0 0 0 41 41 41 41 0 0 0 0 0 0 0 0 0 0 0 0 0 0 0 0 0 0 0 0
0 0 0 0 0 0 0 0 0 0 0 0 0 0 0 0 0 0 0 0 41 41 41 41 0 0 0 0 41 41 41 41 0 0 0 0 0 0 0 0 0 0 0 0 0 0 0 0 0 0 0 0
41 41 41 41 0 0 0 0 41 41 41 41 41 41 41 41 0 0 0 0 0 0 0 0 0 0 0 0 0 0 0 0 0 0 0 0 41 41 41 41 41 41 41 41 0 0 0 0 41 41 41 41
41 41 41 41 0 0 0 0 41 41 41 41 41 41 41 41 0 0 0 0 0 0 0 0 0 0 0 0 0 0 0 0 0 0 0 0 41 41 41 41 41 41 41 41 0 0 0 0 41 41 41 41
44 44 44 44 0 0 0 0 41 41 41 41 41 41 41 41 0 0 0 0 0 0 0 0 0 0 0 0 0 0 0 0 0 0 0 0 41 41 41 41 41 41 41 41 0 0 0 0 44 44 44 44
44 44 44 44 0 0 0 0 41 41 41 41 41 41 41 41 0 0 0 0 0 0 0 0 0 0 0 0 0 0 0 0 0 0 0 0 41 41 41 41 41 41 41 41 0 0 0 0 44 44 44 44
0 0 0 0 0 0 0 0 0 0 0 0 0 0 0 0 0 0 0 0 41 41 41 41 0 0 0 0 41 41 41 41 0 0 0 0 0 0 0 0 0 0 0 0 0 0 0 0 0 0 0 0
0 0 0 0 0 0 0 0 0 0 0 0 0 0 0 0 0 0 0 0 41 41 41 41 0 0 0 0 41 41 41 41 0 0 0 0 0 0 0 0 0 0 0 0 0 0 0 0 0 0 0 0
0 0 0 0 0 0 0 0 0 0 0 0 0 0 0 0 0 0 0 0 41 41 41 41 41 41 41 41 41 41 41 41 0 0 0 0 0 0 0 0 0 0 0 0 0 0 0 0 0 0 0 0
0 0 0 0 0 0 0 0 0 0 0 0 0 0 0 0 0 0 0 0 41 41 41 41 41 41 41 41 41 41 41 41 0 0 0 0 0 0 0 0 0 0 0 0 0 0 0 0 0 0 0 0
0 0 0 0 41 41 41 41 0 0 0 0 41 41 41 41 0 0 0 0 41 41 41 41 41 41 41 41 41 41 41 41 0 0 0 0 41 41 41 41 0 0 0 0 41 41 41 41 0 0 0 0
0 0 0 0 41 41 41 41 0 0 0 0 41 41 41 41 0 0 0 0 41 41 41 41 41 41 41 41 41 41 41 41 0 0 0 0 41 41 41 41 0 0 0 0 41 41 41 41 0 0 0 0
0 0 0 0 41 41 41 41 0 0 0 0 41 41 41 41 0 0 0 0 41 41 41 41 0 0 0 0 41 41 41 41 0 0 0 0 41 41 41 41 0 0 0 0 41 41 41 41 0 0 0 0
0 0 0 0 41 41 41 41 0 0 0 0 41 41 41 41 0 0 0 0 41 41 41 41 0 0 0 0 41 41 41 41 0 0 0 0 41 41 41 41 0 0 0 0 41 41 41 41 0 0 0 0
0 0 0 0 41 41 41 41 0 0 0 0 41 41 41 41 0 0 0 0 41 41 41 41 0 0 0 0 41 41 41 41 0 0 0 0 41 41 41 41 0 0 0 0 41 41 41 41 0 0 0 0
0 0 0 0 41 41 41 41 0 0 0 0 41 41 41 41 0 0 0 0 41 41 41 41 0 0 0 0 41 41 41 41 0 0 0 0 41 41 41 41 0 0 0 0 41 41 41 41 0 0 0 0
0 0 0 0 41 41 41 41 0 0 0 0 41 41 41 41 0 0 0 0 41 41 41 41 0 0 0 0 41 41 41 41 0 0 0 0 41 41 41 41 0 0 0 0 41 41 41 41 0 0 0 0
0 0 0 0 41 41 41 41 0 0 0 0 41 41 41 41 0 0 0 0 41 41 41 41 0 0 0 0 41 41 41 41 0 0 0 0 41 41 41 41 0 0 0 0 41 41 41 41 0 0 0 0
0 0 0 0 41 41 41 41 0 0 0 0 41 41 41 41 0 0 0 0 0 0 0 0 0 0 0 0 0 0 0 0 0 0 0 0 41 41 41 41 0 0 0 0 41 41 41 41 0 0 0 0
0 0 0 0 41 41 41 41 0 0 0 0 41 41 41 41 0 0 0 0 0 0 0 0 0 0 0 0 0 0 0 0 0 0 0 0 41 41 41 41 0 0 0 0 41 41 41 41 0 0 0 0
0 0 0 0 41 41 41 41 0 0 0 0 41 41 41 41 0 0 0 0 0 0 0 0 0 0 0 0 0 0 0 0 0 0 0 0 41 41 41 41 0 0 0 0 41 41 41 41 0 0 0 0
0 0 0 0 41 41 41 41 0 0 0 0 41 41 41 41 0 0 0 0 0 0 0 0 0 0 0 0 0 0 0 0 0 0 0 0 41 41 41 41 0 0 0 0 41 41 41 41 0 0 0 0
0 0 0 0 41 41 41 41 0 0 0 0 41 41 41 41 0 0 0 0 0 0 41 41 41 41 41 41 41 41 0 0 0 0 0 0 41 41 41 41 0 0 0 0 41 41 41 41 0 0 0 0
0 0 0 0 41 41 41 41 0 0 0 0 41 41 41 41 0 0 0 0 0 0 41 41 41 41 41 41 41 41 0 0 0 0 0 0 41 41 41 41 0 0 0 0 41 41 41 41 0 0 0 0
0 0 0 0 0 0 0 0 0 0 0 0 0 0 0 0 0 0 0 0 0 0 41 41 45 45 45 45 41 41 0 0 0 0 0 0 0 0 0 0 0 0 0 0 0 0 0 0 0 0 0 0
0 0 0 0 0 0 0 0 0 0 0 0 0 0 0 0 0 0 0 0 0 0 41 41 45 45 45 45 41 41 0 0 0 0 0 0 0 0 0 0 0 0 0 0 0 0 0 0 0 0 0 0
0 0 0 0 0 0 0 0 0 0 0 0 0 0 0 0 0 0 0 0 0 0 41 41 45 45 45 45 41 41 0 0 0 0 0 0 0 0 0 0 0 0 0 0 0 0 0 0 0 0 0 0
0 0 0 0 0 0 0 0 0 0 0 0 0 0 0 0 0 0 0 0 0 0 41 41 45 45 45 45 41 41 0 0 0 0 0 0 0 0 0 0 0 0 0 0 0 0 0 0 0 0 0 0