0 0 0 0 0 0 0 0 0 0 0 0 0 0 0 0 0 0 0 0 0 0 0 0 0 0 0 0 0 0 0 0 44 44 44 44 44 44 44 44 44 44 44 44 43 43 43 43 0 0 0 0 
0 0 0 0 0 0 0 0 0 0 0 0 0 0 0 0 0 0 0 0 0 0 0 0 0 0 0 0 0 0 0 0 44 44 44 44 44 44 44 44 44 44 44 44 43 43 43 43 0 0 0 0 
0 0 0 0 0 0 0 0 0 0 0 0 0 0 0 0 0 0 0 0 0 0 0 0 0 0 0 0 0 0 0 0 44 44 44 44 44 44 44 44 44 44 44 44 43 43 43 43 0 0 0 0 
0 0 0 0 0 0 0 0 0 0 0 0 0 0 0 0 0 0 0 0 0 0 0 0 0 0 0 0 0 0 0 0 44 44 44 44 44 44 44 44 44 44 44 44 43 43 43 43 0 0 0 0 
0 0 0 0 41 41 41 41 0 0 0 0 0 0 0 0 0 0 0 0 0 0 0 0 0 0 0 0 0 0 0 0 44 44 44 44 0 0 0 0 0 0 0 0 44 44 44 44 0 0 0 0 
0 0 0 0 41 41 41 41 0 0 0 0 0 0 0 0 0 0 0 0 0 0 0 0 0 0 0 0 0 0 0 0 44 44 44 44 0 0 0 0 0 0 0 0 44 44 44 44 0 0 0 0 
0 0 0 0 41 41 41 41 0 0 0 0 0 0 0 0 0 0 0 0 0 0 0 0 0 0 0 0 0 0 0 0 44 44 44 44 0 0 0 0 0 0 0 0 44 44 44 44 0 0 0 0 
0 0 0 0 41 41 41 41 0 0 0 0 0 0 0 0 0 0 0 0 0 0 0 0 0 0 0 0 0 0 0 0 44 44 44 44 0 0 0 0 0 0 0 0 44 44 44 44 0 0 0 0 
41 41 41 41 43 43 43 43 41 41 41 41 0 0 0 0 0 0 0 0 0 0 0 0 41 41 41 41 41 41 41 41 41 41 41 41 41 41 41 41 0 0 0 0 44 44 44 44 0 0 0 0 
41 41 41 41 43 43 43 43 41 41 41 41 0 0 0 0 0 0 0 0 0 0 0 0 41 41 41 41 41 41 41 41 41 41 41 41 41 41 41 41 0 0 0 0 44 44 44 44 0 0 0 0 
41 41 41 41 43 43 43 43 41 41 41 41 0 0 0 0 0 0 0 0 0 0 0 0 41 41 41 41 41 41 41 41 41 41 41 41 41 41 41 41 0 0 0 0 44 44 44 44 0 0 0 0 
41 41 41 41 43 43 43 43 41 41 41 41 0 0 0 0 0 0 0 0 0 0 0 0 41 41 41 41 41 41 41 41 41 41 41 41 41 41 41 41 0 0 0 0 44 44 44 44 0 0 0 0 
0 0 0 0 41 41 41 41 43 43 43 43 41 41 41 41 0 0 0 0 0 0 0 0 41 41 41 41 0 0 0 0 43 43 43 43 41 41 41 41 44 44 44 44 44 44 44 44 0 0 0 0 
0 0 0 0 41 41 41 41 43 43 43 43 41 41 41 41 0 0 0 0 0 0 0 0 41 41 41 41 0 0 0 0 43 43 43 43 41 41 41 41 44 44 44 44 44 44 44 44 0 0 0 0 
0 0 0 0 41 41 41 41 43 43 43 43 41 41 41 41 0 0 0 0 0 0 0 0 41 41 41 41 0 0 0 0 43 43 43 43 41 41 41 41 44 44 44 44 44 44 44 44 0 0 0 0 
0 0 0 0 41 41 41 41 43 43 43 43 41 41 41 41 0 0 0 0 0 0 0 0 41 41 41 41 0 0 0 0 43 43 43 43 41 41 41 41 44 44 44 44 44 44 44 44 0 0 0 0 
0 0 0 0 0 0 0 0 41 41 41 41 0 0 0 0 43 43 43 43 44 44 44 44 41 41 41 41 43 43 43 43 0 0 0 0 41 41 41 41 0 0 0 0 0 0 0 0 0 0 0 0 
0 0 0 0 0 0 0 0 41 41 41 41 0 0 0 0 43 43 43 43 44 44 44 44 41 41 41 41 43 43 43 43 0 0 0 0 41 41 41 41 0 0 0 0 0 0 0 0 0 0 0 0 
0 0 0 0 0 0 0 0 41 41 41 41 0 0 0 0 43 43 43 43 44 44 44 44 41 41 41 41 43 43 43 43 0 0 0 0 41 41 41 41 0 0 0 0 0 0 0 0 0 0 0 0 
0 0 0 0 0 0 0 0 41 41 41 41 0 0 0 0 43 43 43 43 44 44 44 44 41 41 41 41 43 43 43 43 0 0 0 0 41 41 41 41 0 0 0 0 0 0 0 0 0 0 0 0 
0 0 0 0 0 0 0 0 0 0 0 0 0 0 0 0 44 44 44 44 0 0 41 41 41 41 41 41 44 44 44 44 41 41 41 41 41 41 41 41 0 0 0 0 0 0 0 0 0 0 0 0 
0 0 0 0 0 0 0 0 0 0 0 0 0 0 0 0 44 44 44 44 0 0 41 41 41 41 41 41 44 44 44 44 41 41 41 41 41 41 41 41 0 0 0 0 0 0 0 0 0 0 0 0 
0 0 0 0 0 0 0 0 0 0 0 0 0 0 0 0 44 44 44 44 0 0 0 0 41 41 41 41 44 44 44 44 41 41 41 41 41 41 41 41 0 0 0 0 0 0 0 0 0 0 0 0 
0 0 0 0 0 0 0 0 0 0 0 0 0 0 0 0 44 44 44 44 0 0 0 0 41 41 41 41 44 44 44 44 41 41 41 41 41 41 41 41 0 0 0 0 0 0 0 0 0 0 0 0 
0 0 0 0 0 0 0 0 41 41 41 41 41 41 41 41 44 44 44 44 41 41 41 41 0 0 0 0 44 44 44 44 0 0 0 0 0 0 0 0 0 0 0 0 0 0 0 0 0 0 0 0 
0 0 0 0 0 0 0 0 41 41 41 41 41 41 41 41 44 44 44 44 41 41 41 41 0 0 0 0 44 44 44 44 0 0 0 0 0 0 0 0 0 0 0 0 0 0 0 0 0 0 0 0 
0 0 0 0 0 0 0 0 41 41 41 41 41 41 41 41 44 44 44 44 41 41 41 41 0 0 0 0 44 44 44 44 0 0 0 0 0 0 0 0 0 0 0 0 0 0 0 0 0 0 0 0 
0 0 0 0 0 0 0 0 41 41 41 41 41 41 41 41 44 44 44 44 41 41 41 41 0 0 0 0 44 44 44 44 0 0 0 0 0 0 0 0 0 0 0 0 0 0 0 0 0 0 0 0 
0 0 0 0 0 0 0 0 41 41 41 41 0 0 0 0 43 43 43 43 41 41 41 41 44 44 44 44 43 43 43 43 0 0 0 0 0 0 0 0 0 0 0 0 0 0 0 0 0 0 0 0 
0 0 0 0 0 0 0 0 41 41 41 41 0 0 0 0 43 43 43 43 41 41 41 41 44 44 44 44 43 43 43 43 0 0 0 0 0 0 0 0 0 0 0 0 0 0 0 0 0 0 0 0 
0 0 0 0 0 0 0 0 41 41 41 41 0 0 0 0 43 43 43 43 41 41 41 41 44 44 44 44 43 43 43 43 0 0 0 0 0 0 0 0 0 0 0 0 0 0 0 0 0 0 0 0 
0 0 0 0 0 0 0 0 41 41 41 41 0 0 0 0 43 43 43 43 41 41 41 41 44 44 44 44 43 43 43 43 0 0 0 0 0 0 0 0 0 0 0 0 0 0 0 0 0 0 0 0 
44 44 44 44 44 44 44 44 44 44 44 44 43 43 43 43 0 0 0 0 41 41 41 41 0 0 0 0 0 0 0 0 41 41 41 41 41 41 41 41 0 0 0 0 0 0 0 0 0 0 0 0 
44 44 44 44 44 44 44 44 44 44 44 44 43 43 43 43 0 0 0 0 41 41 41 41 0 0 0 0 0 0 0 0 41 41 41 41 41 41 41 41 0 0 0 0 0 0 0 0 0 0 0 0 
44 44 44 44 44 44 44 44 44 44 44 44 43 43 43 43 0 0 0 0 41 41 41 41 0 0 0 0 0 0 0 0 41 41 41 41 41 41 41 41 0 0 0 0 0 0 0 0 0 0 0 0 
44 44 44 44 44 44 44 44 44 44 44 44 43 43 43 43 0 0 0 0 41 41 41 41 0 0 0 0 0 0 0 0 41 41 41 41 41 41 41 41 0 0 0 0 0 0 0 0 0 0 0 0 
44 44 44 44 0 0 0 0 41 41 41 41 41 41 41 41 41 41 41 41 41 41 41 41 0 0 0 0 0 0 0 0 41 41 41 41 44 44 44 44 44 44 44 44 0 0 0 0 0 0 0 0 
44 44 44 44 0 0 0 0 41 41 41 41 41 41 41 41 41 41 41 41 41 41 41 41 0 0 0 0 0 0 0 0 41 41 41 41 44 44 44 44 44 44 44 44 0 0 0 0 0 0 0 0 
44 44 44 44 0 0 0 0 41 41 41 41 41 41 41 41 41 41 41 41 41 41 41 41 0 0 0 0 0 0 0 0 41 41 41 41 44 44 44 44 44 44 44 44 0 0 0 0 0 0 0 0 
44 44 44 44 0 0 0 0 41 41 41 41 41 41 41 41 41 41 41 41 41 41 41 41 0 0 0 0 0 0 0 0 41 41 41 41 44 44 44 44 44 44 44 44 0 0 0 0 0 0 0 0 
44 44 44 44 0 0 0 0 0 0 0 0 44 44 44 44 0 0 0 0 0 0 0 0 0 0 0 0 0 0 0 0 0 0 0 0 44 44 44 44 41 41 41 41 41 41 41 41 0 0 0 0 
44 44 44 44 0 0 0 0 0 0 0 0 44 44 44 44 0 0 0 0 0 0 0 0 0 0 0 0 0 0 0 0 0 0 0 0 44 44 44 44 41 41 41 41 41 41 41 41 0 0 0 0 
44 44 44 44 0 0 0 0 0 0 0 0 44 44 44 44 0 0 0 0 0 0 0 0 0 0 0 0 0 0 0 0 0 0 0 0 44 44 44 44 41 41 41 41 41 41 41 41 0 0 0 0 
44 44 44 44 0 0 0 0 0 0 0 0 44 44 44 44 0 0 0 0 0 0 0 0 0 0 0 0 0 0 0 0 0 0 0 0 44 44 44 44 41 41 41 41 41 41 41 41 0 0 0 0 
43 43 43 43 44 44 44 44 44 44 44 44 44 44 44 44 0 0 0 0 0 0 0 0 0 0 0 0 0 0 0 0 0 0 0 0 0 0 0 0 41 41 41 41 44 44 44 44 44 44 44 44 
43 43 43 43 44 44 44 44 44 44 44 44 44 44 44 44 0 0 0 0 0 0 0 0 0 0 0 0 0 0 0 0 0 0 0 0 0 0 0 0 41 41 41 41 44 44 44 44 44 44 44 44 
43 43 43 43 44 44 44 44 44 44 44 44 44 44 44 44 0 0 0 0 0 0 0 0 0 0 0 0 0 0 0 0 0 0 0 0 0 0 0 0 41 41 41 41 44 44 44 44 44 44 44 44 
43 43 43 43 44 44 44 44 44 44 44 44 44 44 44 44 0 0 0 0 0 0 0 0 0 0 0 0 0 0 0 0 0 0 0 0 0 0 0 0 41 41 41 41 44 44 44 44 44 44 44 44 
0 0 0 0 0 0 0 0 0 0 0 0 0 0 0 0 0 0 0 0 0 0 0 0 0 0 0 0 0 0 0 0 0 0 0 0 0 0 0 0 0 0 0 0 44 44 44 44 44 44 44 44 
0 0 0 0 0 0 0 0 0 0 0 0 0 0 0 0 0 0 0 0 0 0 0 0 0 0 0 0 0 0 0 0 0 0 0 0 0 0 0 0 0 0 0 0 44 44 44 44 44 44 44 44 
0 0 0 0 0 0 0 0 0 0 0 0 0 0 0 0 0 0 0 0 0 0 0 0 0 0 0 0 0 0 0 0 0 0 0 0 0 0 0 0 0 0 0 0 44 44 44 44 44 44 44 44 
0 0 0 0 0 0 0 0 0 0 0 0 0 0 0 0 0 0 0 0 0 0 0 0 0 0 0 0 0 0 0 0 0 0 0 0 0 0 0 0 0 0 0 0 44 44 44 44 44 44 44 44 
