0 0 0 0 0 0 0 0 0 0 0 0 0 0 0 0 0 0 0 0 0 0 0 0 0 0 0 0 41 41 41 41 41 41 41 41 41 41 41 41 0 0 0 0 0 0 0 0 0 0 0 0 
0 0 0 0 0 0 0 0 0 0 0 0 0 0 0 0 0 0 0 0 0 0 0 0 0 0 0 0 41 41 41 41 41 41 41 41 41 41 41 41 0 0 0 0 0 0 0 0 0 0 0 0 
0 0 0 0 0 0 0 0 0 0 0 0 0 0 0 0 0 0 0 0 0 0 0 0 0 0 0 0 41 41 41 41 41 41 41 41 41 41 41 41 0 0 0 0 0 0 0 0 0 0 0 0 
0 0 0 0 0 0 0 0 0 0 0 0 0 0 0 0 0 0 0 0 0 0 0 0 0 0 0 0 41 41 41 41 41 41 41 41 41 41 41 41 0 0 0 0 0 0 0 0 0 0 0 0 
0 0 0 0 41 41 41 41 41 41 41 41 41 41 41 41 0 0 0 0 0 0 0 0 0 0 0 0 0 0 0 0 0 0 0 0 41 41 41 41 0 0 0 0 0 0 0 0 0 0 0 0 
0 0 0 0 41 41 41 41 41 41 41 41 41 41 41 41 0 0 0 0 0 0 0 0 0 0 0 0 0 0 0 0 0 0 0 0 41 41 41 41 0 0 0 0 0 0 0 0 0 0 0 0 
0 0 0 0 41 41 41 41 41 41 41 41 41 41 41 41 41 41 41 41 0 0 0 0 41 41 41 41 0 0 0 0 0 0 0 0 41 41 41 41 0 0 0 0 0 0 0 0 0 0 0 0 
0 0 0 0 41 41 41 41 41 41 41 41 41 41 41 41 41 41 41 41 0 0 0 0 41 41 41 41 0 0 0 0 0 0 0 0 41 41 41 41 0 0 0 0 0 0 0 0 0 0 0 0 
0 0 0 0 0 0 0 0 0 0 0 0 0 0 0 0 41 41 41 41 0 0 0 0 41 41 41 41 0 0 0 0 0 0 0 0 0 0 0 0 0 0 0 0 41 41 41 41 41 41 41 41 
0 0 0 0 0 0 0 0 0 0 0 0 0 0 0 0 41 41 41 41 0 0 0 0 41 41 41 41 0 0 0 0 0 0 0 0 0 0 0 0 0 0 0 0 41 41 41 41 41 41 41 41 
0 0 0 0 0 0 0 0 0 0 0 0 0 0 0 0 41 41 41 41 0 0 0 0 0 0 0 0 0 0 0 0 0 0 0 0 0 0 0 0 0 0 0 0 41 41 41 41 41 41 41 41 
0 0 0 0 0 0 0 0 0 0 0 0 0 0 0 0 41 41 41 41 0 0 0 0 0 0 0 0 0 0 0 0 0 0 0 0 0 0 0 0 0 0 0 0 41 41 41 41 41 41 41 41 
0 0 0 0 42 42 42 42 42 42 42 42 42 42 42 42 42 42 42 42 42 42 42 42 0 0 0 0 41 41 41 41 41 41 0 0 0 0 0 0 0 0 0 0 41 41 41 41 44 44 44 44 
0 0 0 0 42 42 42 42 42 42 42 42 42 42 42 42 42 42 42 42 42 42 42 42 0 0 0 0 41 41 41 41 41 41 0 0 0 0 0 0 0 0 0 0 41 41 41 41 44 44 44 44 
0 0 0 0 42 42 42 42 42 42 42 42 42 42 42 42 42 42 42 42 42 42 42 42 0 0 0 0 41 41 41 41 41 41 0 0 0 0 0 0 0 0 0 0 41 41 41 41 0 0 0 0 
0 0 0 0 42 42 42 42 42 42 42 42 42 42 42 42 42 42 42 42 42 42 42 42 0 0 0 0 41 41 41 41 41 41 0 0 0 0 0 0 0 0 0 0 41 41 41 41 0 0 0 0 
0 0 0 0 0 0 0 0 0 0 0 0 0 0 0 0 0 0 0 0 42 42 42 42 0 0 0 0 41 41 41 41 0 0 0 0 44 44 44 44 44 44 0 0 41 41 41 41 0 0 0 0 
0 0 0 0 0 0 0 0 0 0 0 0 0 0 0 0 0 0 0 0 42 42 42 42 0 0 0 0 41 41 41 41 0 0 0 0 44 44 44 44 44 44 0 0 41 41 41 41 0 0 0 0 
0 0 0 0 0 0 0 0 44 44 44 44 44 44 44 44 44 44 44 44 42 42 42 42 0 0 0 0 41 41 41 41 0 0 0 0 44 44 44 44 44 44 0 0 41 41 41 41 0 0 0 0 
0 0 0 0 0 0 0 0 44 44 44 44 44 44 44 44 44 44 44 44 42 42 42 42 0 0 0 0 41 41 41 41 0 0 0 0 44 44 44 44 44 44 0 0 41 41 41 41 0 0 0 0 
41 41 41 41 0 0 0 0 41 41 41 41 41 41 41 41 41 41 41 41 42 42 42 42 42 42 42 42 42 42 42 42 0 0 0 0 42 42 42 42 41 41 41 41 41 41 41 41 0 0 0 0 
41 41 41 41 0 0 0 0 41 41 41 41 41 41 41 41 41 41 41 41 42 42 42 42 42 42 42 42 42 42 42 42 0 0 0 0 42 42 42 42 41 41 41 41 41 41 41 41 0 0 0 0 
41 41 41 41 0 0 0 0 41 41 41 41 41 41 41 41 41 41 41 41 42 42 42 42 42 42 42 42 42 42 42 42 0 0 0 0 42 42 42 42 41 41 41 41 41 41 41 41 0 0 0 0 
41 41 41 41 0 0 0 0 41 41 41 41 41 41 41 41 41 41 41 41 42 42 42 42 42 42 42 42 42 42 42 42 0 0 0 0 42 42 42 42 41 41 41 41 41 41 41 41 0 0 0 0 
0 0 0 0 0 0 0 0 0 0 0 0 0 0 0 0 44 44 44 44 42 42 42 42 0 0 0 0 0 0 0 0 0 0 0 0 42 42 42 42 44 44 44 44 0 0 0 0 0 0 0 0 
0 0 0 0 0 0 0 0 0 0 0 0 0 0 0 0 44 44 44 44 42 42 42 42 0 0 0 0 0 0 0 0 0 0 0 0 42 42 42 42 44 44 44 44 0 0 0 0 0 0 0 0 
0 0 0 0 0 0 0 0 0 0 0 0 0 0 0 0 44 44 44 44 42 42 42 42 0 0 0 0 0 0 0 0 0 0 0 0 42 42 42 42 0 0 0 0 0 0 0 0 0 0 0 0 
0 0 0 0 0 0 0 0 0 0 0 0 0 0 0 0 44 44 44 44 42 42 42 42 0 0 0 0 0 0 0 0 0 0 0 0 42 42 42 42 0 0 0 0 0 0 0 0 0 0 0 0 
42 42 42 42 42 42 42 42 42 42 42 42 0 0 0 0 42 42 42 42 42 42 42 42 41 41 41 41 41 41 41 41 0 0 0 0 42 42 42 42 0 0 0 0 0 0 0 0 0 0 0 0 
42 42 42 42 42 42 42 42 42 42 42 42 0 0 0 0 42 42 42 42 42 42 42 42 41 41 41 41 41 41 41 41 0 0 0 0 42 42 42 42 0 0 0 0 0 0 0 0 0 0 0 0 
42 42 42 42 42 42 42 42 42 42 42 42 0 0 0 0 42 42 42 42 42 42 42 42 41 41 41 41 41 41 41 41 0 0 0 0 42 42 42 42 0 0 0 0 0 0 0 0 0 0 0 0 
42 42 42 42 42 42 42 42 42 42 42 42 0 0 0 0 42 42 42 42 42 42 42 42 41 41 41 41 41 41 41 41 0 0 0 0 42 42 42 42 0 0 0 0 0 0 0 0 0 0 0 0 
0 0 0 0 0 0 0 0 0 0 0 0 0 0 0 0 0 0 0 0 41 41 41 41 44 44 44 44 44 44 44 44 0 0 0 0 42 42 42 42 42 42 42 42 42 42 42 42 0 0 0 0 
0 0 0 0 0 0 0 0 0 0 0 0 0 0 0 0 0 0 0 0 41 41 41 41 44 44 44 44 44 44 44 44 0 0 0 0 42 42 42 42 42 42 42 42 42 42 42 42 0 0 0 0 
0 0 0 0 0 0 0 0 0 0 0 0 0 0 0 0 0 0 0 0 41 41 41 41 0 0 0 0 0 0 0 0 0 0 0 0 42 42 42 42 42 42 42 42 42 42 42 42 0 0 0 0 
0 0 0 0 0 0 0 0 0 0 0 0 0 0 0 0 0 0 0 0 41 41 41 41 0 0 0 0 0 0 0 0 0 0 0 0 42 42 42 42 42 42 42 42 42 42 42 42 0 0 0 0 
41 41 41 41 41 41 41 41 41 41 41 41 0 0 0 0 0 0 0 0 0 0 0 0 0 0 0 0 0 0 0 0 0 0 0 0 0 0 0 0 0 0 0 0 0 0 0 0 0 0 0 0 
41 41 41 41 41 41 41 41 41 41 41 41 0 0 0 0 0 0 0 0 0 0 0 0 0 0 0 0 0 0 0 0 0 0 0 0 0 0 0 0 0 0 0 0 0 0 0 0 0 0 0 0 
41 41 41 41 41 41 41 41 41 41 41 41 0 0 0 0 0 0 0 0 0 0 0 0 0 0 0 0 0 0 0 0 0 0 0 0 0 0 0 0 0 0 0 0 0 0 0 0 0 0 0 0 
41 41 41 41 41 41 41 41 41 41 41 41 0 0 0 0 0 0 0 0 0 0 0 0 0 0 0 0 0 0 0 0 0 0 0 0 0 0 0 0 0 0 0 0 0 0 0 0 0 0 0 0 
0 0 0 0 0 0 0 0 41 41 41 41 0 0 0 0 44 44 44 44 44 44 44 44 0 0 0 0 0 0 0 0 0 0 0 0 41 41 41 41 41 41 41 41 0 0 0 0 0 0 41 41 
0 0 0 0 0 0 0 0 41 41 41 41 0 0 0 0 44 44 44 44 44 44 44 44 0 0 0 0 0 0 0 0 0 0 0 0 41 41 41 41 41 41 41 41 0 0 0 0 0 0 41 41 
0 0 0 0 0 0 0 0 41 41 41 41 0 0 0 0 0 0 0 0 0 0 0 0 0 0 0 0 0 0 0 0 0 0 0 0 41 41 41 41 41 41 41 41 0 0 0 0 0 0 41 41 
0 0 0 0 0 0 0 0 41 41 41 41 0 0 0 0 0 0 0 0 0 0 0 0 0 0 0 0 0 0 0 0 0 0 0 0 41 41 41 41 41 41 41 41 0 0 0 0 0 0 41 41 
41 41 41 41 0 0 0 0 0 0 0 0 0 0 0 0 0 0 0 0 0 0 0 0 0 0 0 0 0 0 0 0 0 0 0 0 41 41 41 41 0 0 0 0 0 0 0 0 41 41 41 41 
41 41 41 41 0 0 0 0 0 0 0 0 0 0 0 0 0 0 0 0 0 0 0 0 0 0 0 0 0 0 0 0 0 0 0 0 41 41 41 41 0 0 0 0 0 0 0 0 41 41 41 41 
41 41 41 41 0 0 0 0 0 0 0 0 0 0 0 0 0 0 0 0 0 0 0 0 0 0 0 0 0 0 0 0 0 0 0 0 41 41 41 41 0 0 0 0 0 0 0 0 41 41 41 41 
41 41 41 41 0 0 0 0 0 0 0 0 0 0 0 0 0 0 0 0 0 0 0 0 0 0 0 0 0 0 0 0 0 0 0 0 41 41 41 41 0 0 0 0 0 0 0 0 41 41 41 41 
0 0 0 0 0 0 0 0 0 0 0 0 0 0 0 0 0 0 0 0 0 0 0 0 0 0 0 0 0 0 0 0 0 0 0 0 0 0 0 0 0 0 0 0 0 0 0 0 0 0 0 0 
0 0 0 0 0 0 0 0 0 0 0 0 0 0 0 0 0 0 0 0 0 0 0 0 0 0 0 0 0 0 0 0 0 0 0 0 0 0 0 0 0 0 0 0 0 0 0 0 0 0 0 0 
0 0 0 0 0 0 0 0 0 0 0 0 0 0 0 0 0 0 0 0 0 0 0 0 0 0 0 0 0 0 0 0 0 0 0 0 0 0 0 0 0 0 0 0 0 0 0 0 0 0 0 0 
0 0 0 0 0 0 0 0 0 0 0 0 0 0 0 0 0 0 0 0 0 0 0 0 0 0 0 0 0 0 0 0 0 0 0 0 0 0 0 0 0 0 0 0 0 0 0 0 0 0 0 0 
