0 0 0 0 0 0 0 0 0 0 0 0 0 0 0 0 0 0 0 0 0 0 0 0 0 0 0 0 0 0 0 0 0 0 0 0 0 0 0 0 0 0 0 0 0 0 0 0 0 0 0 0 
0 0 0 0 0 0 0 0 0 0 0 0 0 0 0 0 0 0 0 0 0 0 0 0 0 0 0 0 0 0 0 0 0 0 0 0 0 0 0 0 0 0 0 0 0 0 0 0 0 0 0 0 
0 0 0 0 0 0 0 0 0 0 0 0 0 0 0 0 0 0 0 0 0 0 0 0 0 0 0 0 0 0 0 0 0 0 0 0 0 0 0 0 41 41 41 41 0 0 0 0 0 0 0 0 
0 0 0 0 0 0 0 0 0 0 0 0 0 0 0 0 0 0 0 0 0 0 0 0 0 0 0 0 0 0 0 0 0 0 0 0 0 0 0 0 41 41 41 41 0 0 0 0 0 0 0 0 
0 0 0 0 0 0 0 0 0 0 0 0 0 0 0 0 41 41 0 0 0 0 0 0 0 0 0 0 40 40 40 40 40 40 40 40 40 40 40 40 41 41 41 41 41 41 41 41 0 0 0 0 
0 0 0 0 0 0 0 0 0 0 0 0 0 0 0 0 41 41 0 0 0 0 0 0 0 0 0 0 40 40 40 40 40 40 40 40 40 40 40 40 41 41 41 41 41 41 41 41 0 0 0 0 
0 0 0 0 41 41 41 41 0 0 0 0 41 41 41 41 41 41 41 41 0 0 0 0 0 0 0 0 40 40 40 40 40 40 40 40 40 40 40 40 41 41 41 41 41 41 41 41 0 0 0 0 
0 0 0 0 41 41 41 41 0 0 0 0 41 41 41 41 41 41 41 41 0 0 0 0 0 0 0 0 40 40 40 40 40 40 40 40 40 40 40 40 41 41 41 41 41 41 41 41 0 0 0 0 
0 0 0 0 41 41 41 41 0 0 0 0 41 41 41 41 41 41 41 41 0 0 0 0 44 44 44 44 40 40 40 40 40 40 40 40 40 40 40 40 40 40 40 40 40 40 40 40 0 0 0 0 
0 0 0 0 41 41 41 41 0 0 0 0 41 41 41 41 41 41 41 41 0 0 0 0 44 44 44 44 40 40 40 40 40 40 40 40 40 40 40 40 40 40 40 40 40 40 40 40 0 0 0 0 
0 0 0 0 41 41 41 41 0 0 0 0 0 0 0 0 41 41 41 41 0 0 0 0 44 44 44 44 40 40 40 40 40 40 40 40 40 40 40 40 40 40 40 40 40 40 40 40 0 0 0 0 
0 0 0 0 41 41 41 41 0 0 0 0 0 0 0 0 41 41 41 41 0 0 0 0 44 44 44 44 40 40 40 40 40 40 40 40 40 40 40 40 40 40 40 40 40 40 40 40 0 0 0 0 
0 0 0 0 41 41 41 41 0 0 0 0 0 0 0 0 41 41 41 41 0 0 0 0 0 0 0 0 41 41 41 41 40 40 40 40 40 40 40 40 40 40 40 40 40 40 40 40 0 0 0 0 
0 0 0 0 41 41 41 41 0 0 0 0 0 0 0 0 41 41 41 41 0 0 0 0 0 0 0 0 41 41 41 41 40 40 40 40 40 40 40 40 40 40 40 40 40 40 40 40 0 0 0 0 
40 40 40 40 40 40 40 40 40 40 40 40 44 44 0 0 41 41 41 41 0 0 0 0 0 0 0 0 41 41 41 41 40 40 40 40 40 40 40 40 40 40 40 40 40 40 40 40 0 0 0 0 
40 40 40 40 40 40 40 40 40 40 40 40 44 44 0 0 41 41 41 41 0 0 0 0 0 0 0 0 41 41 41 41 40 40 40 40 40 40 40 40 40 40 40 40 40 40 40 40 0 0 0 0 
40 40 40 40 40 40 40 40 40 40 40 40 44 44 0 0 41 41 41 41 0 0 0 0 41 41 41 41 41 41 41 41 0 0 41 41 41 41 0 0 0 0 0 0 0 0 0 0 0 0 0 0 
40 40 40 40 40 40 40 40 40 40 40 40 44 44 0 0 41 41 41 41 0 0 0 0 41 41 41 41 41 41 41 41 0 0 41 41 41 41 0 0 0 0 0 0 0 0 0 0 0 0 0 0 
40 40 40 40 40 40 40 40 40 40 40 40 40 40 40 40 40 40 40 40 40 40 40 40 41 41 41 41 41 41 41 41 0 0 41 41 41 41 0 0 0 0 0 0 0 0 0 0 0 0 0 0 
40 40 40 40 40 40 40 40 40 40 40 40 40 40 40 40 40 40 40 40 40 40 40 40 41 41 41 41 41 41 41 41 0 0 41 41 41 41 0 0 0 0 0 0 0 0 0 0 0 0 0 0 
0 0 0 0 0 0 0 0 0 0 44 44 40 40 40 40 40 40 40 40 40 40 40 40 40 40 40 40 41 41 41 41 0 0 41 41 41 41 0 0 0 0 0 0 44 44 44 44 44 44 44 44 
0 0 0 0 0 0 0 0 0 0 44 44 40 40 40 40 40 40 40 40 40 40 40 40 40 40 40 40 41 41 41 41 0 0 41 41 41 41 0 0 0 0 0 0 44 44 44 44 44 44 44 44 
0 0 0 0 0 0 0 0 0 0 44 44 40 40 40 40 40 40 40 40 40 40 40 40 40 40 40 40 41 41 41 41 0 0 41 41 41 41 0 0 0 0 0 0 0 0 0 0 0 0 0 0 
0 0 0 0 0 0 0 0 0 0 44 44 40 40 40 40 40 40 40 40 40 40 40 40 40 40 40 40 41 41 41 41 0 0 41 41 41 41 0 0 0 0 0 0 0 0 0 0 0 0 0 0 
41 41 41 41 41 41 41 41 41 41 41 41 41 41 41 41 40 40 40 40 40 40 40 40 40 40 40 40 40 40 40 40 40 40 40 40 40 40 40 40 40 40 40 40 41 41 41 41 41 41 41 41 
41 41 41 41 41 41 41 41 41 41 41 41 41 41 41 41 40 40 40 40 40 40 40 40 40 40 40 40 40 40 40 40 40 40 40 40 40 40 40 40 40 40 40 40 41 41 41 41 41 41 41 41 
41 41 41 41 41 41 41 41 41 41 41 41 41 41 41 41 40 40 40 40 40 40 40 40 40 40 40 40 40 40 40 40 40 40 40 40 40 40 40 40 40 40 40 40 41 41 41 41 41 41 41 41 
41 41 41 41 41 41 41 41 41 41 41 41 41 41 41 41 40 40 40 40 40 40 40 40 40 40 40 40 40 40 40 40 40 40 40 40 40 40 40 40 40 40 40 40 41 41 41 41 41 41 41 41 
0 0 0 0 0 0 0 0 0 0 0 0 41 41 41 41 41 41 41 41 40 40 40 40 40 40 40 40 40 40 40 40 40 40 40 40 44 44 0 0 0 0 0 0 0 0 0 0 0 0 0 0 
0 0 0 0 0 0 0 0 0 0 0 0 41 41 41 41 41 41 41 41 40 40 40 40 40 40 40 40 40 40 40 40 40 40 40 40 44 44 0 0 0 0 0 0 0 0 0 0 0 0 0 0 
0 0 0 0 0 0 0 0 0 0 0 0 41 41 41 41 41 41 41 41 40 40 40 40 40 40 40 40 40 40 40 40 40 40 40 40 44 44 0 0 0 0 0 0 0 0 0 0 0 0 0 0 
0 0 0 0 0 0 0 0 0 0 0 0 41 41 41 41 41 41 41 41 40 40 40 40 40 40 40 40 40 40 40 40 40 40 40 40 44 44 0 0 0 0 0 0 0 0 0 0 0 0 0 0 
0 0 0 0 41 41 41 41 41 41 41 41 41 41 41 41 0 0 0 0 40 40 40 40 40 40 40 40 40 40 40 40 41 41 41 41 41 41 41 41 0 0 0 0 41 41 41 41 0 0 0 0 
0 0 0 0 41 41 41 41 41 41 41 41 41 41 41 41 0 0 0 0 40 40 40 40 40 40 40 40 40 40 40 40 41 41 41 41 41 41 41 41 0 0 0 0 41 41 41 41 0 0 0 0 
0 0 0 0 41 41 41 41 41 41 41 41 41 41 41 41 0 0 0 0 40 40 40 40 40 40 40 40 40 40 40 40 41 41 41 41 41 41 41 41 0 0 0 0 41 41 41 41 0 0 0 0 
0 0 0 0 41 41 41 41 41 41 41 41 41 41 41 41 0 0 0 0 40 40 40 40 40 40 40 40 40 40 40 40 41 41 41 41 41 41 41 41 0 0 0 0 41 41 41 41 0 0 0 0 
40 40 40 40 40 40 40 40 40 40 40 40 41 41 41 41 40 40 40 40 0 0 0 0 0 0 0 0 0 0 0 0 0 0 0 0 41 41 41 41 0 0 0 0 41 41 41 41 0 0 0 0 
40 40 40 40 40 40 40 40 40 40 40 40 41 41 41 41 40 40 40 40 0 0 0 0 0 0 0 0 0 0 0 0 0 0 0 0 41 41 41 41 0 0 0 0 41 41 41 41 0 0 0 0 
40 40 40 40 40 40 40 40 40 40 40 40 41 41 41 41 40 40 40 40 0 0 0 0 0 0 0 0 0 0 0 0 0 0 0 0 41 41 41 41 0 0 0 0 41 41 41 41 0 0 0 0 
40 40 40 40 40 40 40 40 40 40 40 40 41 41 41 41 40 40 40 40 0 0 0 0 0 0 0 0 0 0 0 0 0 0 0 0 41 41 41 41 0 0 0 0 41 41 41 41 0 0 0 0 
40 40 40 40 40 40 40 40 40 40 40 40 40 40 40 40 40 40 40 40 44 44 44 44 0 0 0 0 44 44 44 44 0 0 0 0 0 0 0 0 0 0 0 0 41 41 41 41 0 0 0 0 
40 40 40 40 40 40 40 40 40 40 40 40 40 40 40 40 40 40 40 40 44 44 44 44 0 0 0 0 44 44 44 44 0 0 0 0 0 0 0 0 0 0 0 0 41 41 41 41 0 0 0 0 
40 40 40 40 40 40 40 40 40 40 40 40 40 40 40 40 40 40 40 40 0 0 0 0 0 0 0 0 0 0 0 0 0 0 0 0 0 0 0 0 41 41 41 41 41 41 41 41 0 0 0 0 
40 40 40 40 40 40 40 40 40 40 40 40 40 40 40 40 40 40 40 40 0 0 0 0 0 0 0 0 0 0 0 0 0 0 0 0 0 0 0 0 41 41 41 41 41 41 41 41 0 0 0 0 
41 41 41 41 40 40 40 40 40 40 40 40 40 40 40 40 40 40 40 40 0 0 0 0 0 0 0 0 0 0 0 0 0 0 0 0 41 41 41 41 0 0 0 0 0 0 0 0 0 0 0 0 
41 41 41 41 40 40 40 40 40 40 40 40 40 40 40 40 40 40 40 40 0 0 0 0 0 0 0 0 0 0 0 0 0 0 0 0 41 41 41 41 0 0 0 0 0 0 0 0 0 0 0 0 
41 41 41 41 40 40 40 40 40 40 40 40 40 40 40 40 40 40 40 40 0 0 0 0 0 0 0 0 0 0 0 0 0 0 0 0 41 41 41 41 0 0 0 0 0 0 0 0 0 0 0 0 
41 41 41 41 40 40 40 40 40 40 40 40 40 40 40 40 40 40 40 40 0 0 0 0 0 0 0 0 0 0 0 0 0 0 0 0 41 41 41 41 0 0 0 0 0 0 0 0 0 0 0 0 
41 41 41 41 41 41 41 41 44 44 0 0 0 0 0 0 0 0 0 0 0 0 0 0 0 0 0 0 0 0 0 0 0 0 0 0 41 41 41 41 0 0 0 0 41 41 41 41 0 0 0 0 
41 41 41 41 41 41 41 41 44 44 0 0 0 0 0 0 0 0 0 0 0 0 0 0 0 0 0 0 0 0 0 0 0 0 0 0 41 41 41 41 0 0 0 0 41 41 41 41 0 0 0 0 
41 41 41 41 41 41 41 41 44 44 0 0 0 0 0 0 0 0 0 0 0 0 0 0 0 0 0 0 0 0 0 0 0 0 0 0 41 41 41 41 0 0 0 0 41 41 41 41 0 0 0 0 
41 41 41 41 41 41 41 41 44 44 0 0 0 0 0 0 0 0 0 0 0 0 0 0 0 0 0 0 0 0 0 0 0 0 0 0 41 41 41 41 0 0 0 0 41 41 41 41 0 0 0 0 
