0 0 0 0 0 0 0 0 0 0 0 0 0 0 0 0 41 41 0 0 0 0 41 41 0 0 0 0 0 0 0 0 0 0 0 0 0 0 0 0 0 0 0 0 0 0 0 0 0 0 0 0 
0 0 0 0 0 0 0 0 0 0 0 0 0 0 0 0 41 41 0 0 0 0 41 41 0 0 0 0 0 0 0 0 0 0 0 0 0 0 0 0 0 0 0 0 0 0 0 0 0 0 0 0 
0 0 0 0 0 0 0 0 0 0 0 0 0 0 0 0 41 41 0 0 0 0 41 41 0 0 0 0 0 0 0 0 0 0 0 0 0 0 0 0 0 0 0 0 0 0 0 0 0 0 0 0 
0 0 0 0 0 0 0 0 0 0 0 0 0 0 0 0 41 41 0 0 0 0 41 41 0 0 0 0 0 0 0 0 0 0 0 0 0 0 0 0 0 0 0 0 0 0 0 0 0 0 0 0 
41 41 0 0 41 41 0 0 41 41 0 0 0 0 41 41 0 0 0 0 41 41 0 0 0 0 0 0 0 0 0 0 41 41 0 0 41 41 0 0 0 0 0 0 0 0 0 0 0 0 0 0 
41 41 0 0 41 41 0 0 41 41 0 0 0 0 41 41 0 0 0 0 41 41 0 0 0 0 0 0 0 0 0 0 41 41 0 0 41 41 0 0 0 0 0 0 0 0 0 0 0 0 0 0 
41 41 0 0 41 41 0 0 41 41 0 0 0 0 41 41 0 0 0 0 41 41 0 0 0 0 0 0 0 0 0 0 41 41 0 0 41 41 0 0 0 0 0 0 0 0 0 0 0 0 0 0 
41 41 0 0 41 41 0 0 41 41 0 0 0 0 41 41 0 0 0 0 41 41 0 0 0 0 0 0 0 0 0 0 41 41 0 0 41 41 0 0 0 0 0 0 0 0 0 0 0 0 0 0 
41 41 0 0 41 41 0 0 41 41 0 0 41 41 41 41 41 41 41 41 0 0 0 0 0 0 0 0 0 0 0 0 41 41 0 0 41 41 41 41 41 41 0 0 0 0 0 0 0 0 0 0 
41 41 0 0 41 41 0 0 41 41 0 0 41 41 41 41 41 41 41 41 0 0 0 0 0 0 0 0 0 0 0 0 41 41 0 0 41 41 41 41 41 41 0 0 0 0 0 0 0 0 0 0 
41 41 0 0 41 41 0 0 41 41 0 0 41 41 41 41 41 41 41 41 0 0 0 0 0 0 0 0 0 0 0 0 41 41 0 0 41 41 41 41 41 41 0 0 0 0 0 0 0 0 0 0 
41 41 0 0 41 41 0 0 41 41 0 0 41 41 41 41 41 41 41 41 0 0 0 0 0 0 0 0 0 0 0 0 41 41 0 0 41 41 41 41 41 41 0 0 0 0 0 0 0 0 0 0 
0 0 41 41 0 0 41 41 0 0 0 0 41 41 41 41 41 41 0 0 0 0 0 0 0 0 0 0 0 0 41 41 41 41 0 0 41 41 41 41 41 41 41 41 0 0 0 0 0 0 0 0 
0 0 41 41 0 0 41 41 0 0 0 0 41 41 41 41 41 41 0 0 0 0 0 0 0 0 0 0 0 0 41 41 41 41 0 0 41 41 41 41 41 41 41 41 0 0 0 0 0 0 0 0 
0 0 41 41 0 0 41 41 0 0 0 0 41 41 41 41 41 41 0 0 0 0 0 0 0 0 0 0 0 0 41 41 41 41 0 0 41 41 41 41 41 41 41 41 0 0 0 0 0 0 0 0 
0 0 41 41 0 0 41 41 0 0 0 0 41 41 41 41 41 41 0 0 0 0 0 0 0 0 0 0 0 0 41 41 41 41 0 0 41 41 41 41 41 41 41 41 0 0 0 0 0 0 0 0 
0 0 0 0 41 41 0 0 0 0 0 0 41 41 41 41 0 0 41 41 41 41 0 0 0 0 0 0 41 41 0 0 41 41 41 41 41 41 41 41 41 41 41 41 0 0 0 0 0 0 0 0 
0 0 0 0 41 41 0 0 0 0 0 0 41 41 41 41 0 0 41 41 41 41 0 0 0 0 0 0 41 41 0 0 41 41 41 41 41 41 41 41 41 41 41 41 0 0 0 0 0 0 0 0 
0 0 0 0 41 41 0 0 0 0 0 0 41 41 41 41 0 0 41 41 41 41 0 0 0 0 0 0 41 41 0 0 41 41 41 41 41 41 41 41 41 41 41 41 0 0 0 0 0 0 0 0 
0 0 0 0 41 41 0 0 0 0 0 0 41 41 41 41 0 0 41 41 41 41 0 0 0 0 0 0 41 41 0 0 41 41 41 41 41 41 41 41 41 41 41 41 0 0 0 0 0 0 0 0 
0 0 0 0 41 41 0 0 0 0 41 41 0 0 0 0 0 0 0 0 41 41 41 41 41 41 0 0 41 41 41 41 0 0 41 41 0 0 41 41 41 41 41 41 0 0 0 0 0 0 0 0 
0 0 0 0 41 41 0 0 0 0 41 41 0 0 0 0 0 0 0 0 41 41 41 41 41 41 0 0 41 41 41 41 0 0 41 41 0 0 41 41 41 41 41 41 0 0 0 0 0 0 0 0 
0 0 0 0 41 41 0 0 0 0 41 41 0 0 0 0 0 0 0 0 41 41 41 41 41 41 0 0 41 41 41 41 0 0 41 41 0 0 41 41 41 41 41 41 0 0 0 0 0 0 0 0 
0 0 0 0 41 41 0 0 0 0 41 41 0 0 0 0 0 0 0 0 41 41 41 41 41 41 0 0 41 41 41 41 0 0 41 41 0 0 41 41 41 41 41 41 0 0 0 0 0 0 0 0 
0 0 0 0 41 41 0 0 0 0 0 0 0 0 0 0 0 0 41 41 41 41 41 41 41 41 41 41 41 41 0 0 0 0 0 0 41 41 0 0 41 41 41 41 0 0 0 0 0 0 0 0 
0 0 0 0 41 41 0 0 0 0 0 0 0 0 0 0 0 0 41 41 41 41 41 41 41 41 41 41 41 41 0 0 0 0 0 0 41 41 0 0 41 41 41 41 0 0 0 0 0 0 0 0 
0 0 0 0 41 41 0 0 0 0 0 0 0 0 0 0 0 0 41 41 41 41 41 41 41 41 41 41 41 41 0 0 0 0 0 0 41 41 0 0 41 41 41 41 0 0 0 0 0 0 0 0 
0 0 0 0 41 41 0 0 0 0 0 0 0 0 0 0 0 0 41 41 41 41 41 41 41 41 41 41 41 41 0 0 0 0 0 0 41 41 0 0 41 41 41 41 0 0 0 0 0 0 0 0 
0 0 0 0 41 41 0 0 0 0 0 0 0 0 0 0 41 41 0 0 41 41 41 41 41 41 41 41 41 41 0 0 0 0 0 0 41 41 0 0 41 41 41 41 0 0 0 0 0 0 0 0 
0 0 0 0 41 41 0 0 0 0 0 0 0 0 0 0 41 41 0 0 41 41 41 41 41 41 41 41 41 41 0 0 0 0 0 0 41 41 0 0 41 41 41 41 0 0 0 0 0 0 0 0 
0 0 0 0 0 0 41 41 0 0 0 0 0 0 0 0 41 41 0 0 41 41 41 41 41 41 41 41 41 41 0 0 0 0 0 0 41 41 0 0 41 41 41 41 0 0 0 0 0 0 0 0 
0 0 0 0 0 0 41 41 0 0 0 0 0 0 0 0 41 41 0 0 41 41 41 41 41 41 41 41 41 41 0 0 0 0 0 0 41 41 0 0 41 41 41 41 0 0 0 0 0 0 0 0 
0 0 0 0 0 0 41 41 41 41 41 41 41 41 41 41 0 0 0 0 41 41 41 41 41 41 41 41 41 41 41 41 0 0 0 0 41 41 0 0 41 41 0 0 41 41 41 41 41 41 41 41 
0 0 0 0 0 0 41 41 41 41 41 41 41 41 41 41 0 0 0 0 41 41 41 41 41 41 41 41 41 41 41 41 0 0 0 0 41 41 0 0 41 41 0 0 41 41 41 41 41 41 41 41 
0 0 0 0 0 0 41 41 0 0 0 0 0 0 0 0 0 0 0 0 41 41 41 41 41 41 41 41 41 41 41 41 0 0 0 0 41 41 0 0 41 41 0 0 0 0 0 0 41 41 41 41 
0 0 0 0 0 0 41 41 0 0 0 0 0 0 0 0 0 0 0 0 41 41 41 41 41 41 41 41 41 41 41 41 0 0 0 0 41 41 0 0 41 41 0 0 0 0 0 0 41 41 41 41 
0 0 0 0 0 0 41 41 0 0 0 0 0 0 0 0 0 0 41 41 41 41 0 0 41 41 41 41 0 0 41 41 41 41 0 0 41 41 0 0 41 41 0 0 0 0 41 41 0 0 41 41 
0 0 0 0 0 0 41 41 0 0 0 0 0 0 0 0 0 0 41 41 41 41 0 0 41 41 41 41 0 0 41 41 41 41 0 0 41 41 0 0 41 41 0 0 0 0 41 41 0 0 41 41 
0 0 0 0 0 0 41 41 0 0 0 0 0 0 0 0 0 0 41 41 41 41 0 0 41 41 41 41 0 0 41 41 41 41 0 0 41 41 0 0 41 41 0 0 0 0 41 41 0 0 0 0 
0 0 0 0 0 0 41 41 0 0 0 0 0 0 0 0 0 0 41 41 41 41 0 0 41 41 41 41 0 0 41 41 41 41 0 0 41 41 0 0 41 41 0 0 0 0 41 41 0 0 0 0 
0 0 0 0 0 0 41 41 0 0 0 0 0 0 0 0 41 41 41 41 0 0 41 41 41 41 0 0 41 41 41 41 41 41 41 41 0 0 0 0 0 0 0 0 0 0 41 41 0 0 0 0 
0 0 0 0 0 0 41 41 0 0 0 0 0 0 0 0 41 41 41 41 0 0 41 41 41 41 0 0 41 41 41 41 41 41 41 41 0 0 0 0 0 0 0 0 0 0 41 41 0 0 0 0 
0 0 0 0 0 0 0 0 41 41 0 0 0 0 0 0 41 41 41 41 0 0 41 41 41 41 0 0 41 41 41 41 41 41 41 41 0 0 0 0 0 0 0 0 0 0 41 41 0 0 0 0 
0 0 0 0 0 0 0 0 41 41 0 0 0 0 0 0 41 41 41 41 0 0 41 41 41 41 0 0 41 41 41 41 41 41 41 41 0 0 0 0 0 0 0 0 0 0 41 41 0 0 0 0 
0 0 0 0 0 0 0 0 41 41 0 0 0 0 41 41 41 41 0 0 0 0 0 0 0 0 0 0 0 0 0 0 41 41 41 41 41 41 0 0 0 0 0 0 41 41 0 0 0 0 0 0 
0 0 0 0 0 0 0 0 41 41 0 0 0 0 41 41 41 41 0 0 0 0 0 0 0 0 0 0 0 0 0 0 41 41 41 41 41 41 0 0 0 0 0 0 41 41 0 0 0 0 0 0 
0 0 0 0 0 0 0 0 41 41 0 0 0 0 41 41 41 41 0 0 0 0 41 41 41 41 41 41 41 41 0 0 41 41 41 41 41 41 0 0 0 0 0 0 41 41 0 0 0 0 0 0 
0 0 0 0 0 0 0 0 41 41 0 0 0 0 41 41 41 41 0 0 0 0 41 41 41 41 41 41 41 41 0 0 41 41 41 41 41 41 0 0 0 0 0 0 41 41 0 0 0 0 0 0 
0 0 0 0 0 0 0 0 41 41 0 0 0 0 41 41 0 0 0 0 0 0 41 41 45 45 45 45 41 41 0 0 0 0 0 0 41 41 41 41 41 41 41 41 0 0 0 0 0 0 0 0 
0 0 0 0 0 0 0 0 41 41 0 0 0 0 41 41 0 0 0 0 0 0 41 41 45 45 45 45 41 41 0 0 0 0 0 0 41 41 41 41 41 41 41 41 0 0 0 0 0 0 0 0 
0 0 0 0 0 0 0 0 41 41 0 0 0 0 41 41 0 0 0 0 0 0 41 41 45 45 45 45 41 41 0 0 0 0 0 0 41 41 41 41 41 41 41 41 0 0 0 0 0 0 0 0 
0 0 0 0 0 0 0 0 41 41 0 0 0 0 41 41 0 0 0 0 0 0 41 41 45 45 45 45 41 41 0 0 0 0 0 0 41 41 41 41 41 41 41 41 0 0 0 0 0 0 0 0 
